"filename", "language", "Go", "Ini", "comment", "blank", "total"
"d:\code\seckill\demo\config.ini", "Ini", 0, 1, 0, 0, 1
"d:\code\seckill\demo\config\conf.go", "Go", 1, 0, 0, -2, -1
"d:\code\seckill\demo\data\data_source.go", "Go", 1, 0, -2, 0, -1
"d:\code\seckill\demo\data\rabbitmq.go", "Go", 31, 0, 1, 2, 34
"d:\code\seckill\demo\handler\handler.go", "Go", 2, 0, 0, 2, 4
"d:\code\seckill\demo\model\interface.go", "Go", 5, 0, 0, 0, 5
"d:\code\seckill\demo\model\order.go", "Go", -2, 0, 2, 0, 0
"d:\code\seckill\demo\repository\rabbitmq_repository.go", "Go", 28, 0, 23, 8, 59
"d:\code\seckill\demo\service\goods_service.go", "Go", 30, 0, -1, 3, 32
"Total", "-", 96, 1, 23, 13, 133